FFFFFFFFFFFFFFFFFFFF
FGGGGGGGGGGGGGGGGGGF
FGGGGGGGGGGGGGGGGGGF
FGGGGGGGGGGGGGGGGGGF
FGGGCGGGGGGGGGGGGGGF
FGGGGGGGGGGGGGGGGGGF
FGGGGGGGGGGGGGGGGGGF
FGGGGGGGGGGGGGGGGGGF
FGGGGGGGGGGGGGGGGGGF
FGGGGGGGGGGGGGGGGGGF
FGGGGGGGGGGGGGGGGGGF
FGGGGGGGGGGGGGGGGGGF
FGGGGGGGGGGGGGGGGGGF
FGGGGGGGGGGGGGGGGGGF
FGGGGGGGGGGGGGGGGGGF
FGGGGGGGGGGGGGGSGGGF
FGGGGGGGGGGGGGGGGGGF
FGGGGGGGGGGGGGGGGGGF
FGGGGGGGGGGGGGGGGGGF
FFFFFFFFFFFFFFFFFFFF