FFFFFFFFFFFFFFFFFFFF
FDDDDDDDDDDDDDDDDDDF
FFGGGGGGGGGGGGGGGGRF
FFGGGGGGGGGGGGGGGGRF
FFGGCGGGGGGGGGGGGGRF
FFGGGGGGGGGGGGGGGGRF
FFGGGGGGGGGGGGGGGGRF
FFGGGGGGGGGGGGGGGGRF
FFGGGGGGGGGGGGGGGGRF
FFGGGGGGGGGGGGGGGGRF
FFGGGGGGGGGGGGGGGGRF
FFGGGGGGGGGGGGGGGGRF
FFGGGGGGGGGGGGGGGGRF
FFGGGGGGGGGGGGGGGGRF
FFGGGGGGGGGGGGGGGGRF
FFGGGGGGGGGGGGGSGGRF
FFGGGGGGGGGGGGGGGGRF
FFGGGGGGGGGGGGGGGGRF
FFGGGGGGGGGGGGGGGGRF
FFFFFFFFFFFFFFFFFFFF